1111111111111
1001000000001
1000011111C01
1P10110E00001
1111111111111