11111111111111111111111111111111111111111111111111111111111111111111111111111111
10000000000000000000000000000000000000000000000000000000000000000001100000000001
10000000000000000000000000000000000000000000000000000000000000000001100000000001
10000000000000000000000000000000000000000000000000000000000000000001100000000001
10000000000000P00000000000000000000000000000000000000000000000000001100000000001
10000000000000000000000000000000000000000000000000000000000000000001100000000001
10000000000000000000000000000000000000000000000000000000000000000001100000000001
10000000000000000000000000000000000000000000000000000000000000000001100000000001
10000000000000000000000000000000000000000000000000000000000000000001100000000001
10000000000000000000000000000000000000000000000000000000000000011001100000000001
10000000000000000000000000000000000000000000000000000000000000011000E00000000001
11111111111111111111111111111100000000000000000000000000000000011000000000000001
10000000000000000000000000000000000000000000000000000000000000011000000000000001
10000000000000000000000000000000000000000000000000000000000000011000000000000001
1000000000000000000000000000C000000000000000000000000000000000011000000000000001
10000000000000000000000000011110000000000000000000000000000000000000000000000001
10000000000000000000000000011110000000000000000000000000000000000000000000000001
10000000000000000000000000011110000000000000000000000000000000000000000000000001
10000000000000000000000000011110000000000000000000000000000000000000000000000001
10000000000000000000000000011110000000000000000000000000000000000000000000000001
10000000000000000000000000011110000000000000000000000000000000000000000000000001
10000000000000000000000000011110000000000000000000000000000000000000000000000001
10000000000000000000000000011110000000000000000000000000000000000000000000000001
10000000000000000000000000011110000000000000000000000000000000000000000000000001
10000000000000000000000000011110000000000000000000000000000000000000000000000001
10000000000000000000000000011110000000000000000000000000000000000000000000000001
10011111111111111111111111111111111111111111110000000000000000000000000000000001
10011111111111111111111111111111111111111111110000000000000000000000000000000001
10000000000000000000000000000000000000000000000000000000000000000000000000000001
10000000000000000000000000000000000000000000000000000000000000000000000000000001
10000000000000000000000000000000000000000000000000000000000000000000000000000001
10000000000000000000000000000000000000000000000000000000000000000000000000000001
10000000000000000000000000000000000000000000000000000000000000000000000000000001
10000000000000000000000000000000000000000000000000000000000000000000000000000001
10000000000000000000000000000000000000000000000000000000000000000000000000000001
10000000000000000000000000000000000000000000000000000000000000000000000000000001
10000000000000000000000000000000000000000000000000000000000000000000000000000001
10000000000000000000000000000000000000000000000000000000000000000000000000000001
10000000000000000000000000000000000000000000000000000000000000000000000000000001
10000000000000000000000000000000000000000000000000000000000000000000000000000001
10000000000000000000000000000000000000000000000000000000000000000000000000000001
10000000000000000000000000000000000000000000000000000000000000000000000000000001
11111111111111111111111111111111111111111111111111111111111111111111111111111111